11111
1P011
10001
10001
11111
