       111
11111000
1P01     1
10001
10  001
1111000000000000000001
111111111111111111111