11101
1P011
10001
1000P
11111
